108
8
22 22 22 22 22 4  0  0  0  0  0  0  0  0  0  0  0  0 0 0 0 0  0  0  0 0 0 0 0 0  0  0  0 0 0 0 0 0  0  0  0  0  0  0  0  0 0 0 0 0 0  0  0  0  0  0  0  0 0 0 0 0 0 0  0  0  0  0 0 0 0  0 0 0  0 0 0 0  0 0 0  0 0 0 0  0 0 0  0  0  0 0 0  0 0 0  0 0 0  0 0 0  0 0 0  0 3 22
22 22 22 22 22 4  0  0  0  0  0  0  0  0  0  0  0  0 0 0 0 0  0  0  0 0 0 0 0 0  0  0  0 0 0 0 0 0  0  0  0  0  0  0  0  0 0 0 0 0 0  0  0  0  0  0  0  0 0 0 0 0 0 0  0  0  0  0 0 0 0  0 0 0  0 0 0 0  0 0 0  0 0 0 0  0 0 0  0  0  0 0 0  0 0 0  0 0 0  0 0 0  0 0 0  0 3 22
22 22 22 22 22 4  0  0  0  0  0  0  0  0  0  0  0  0 0 0 0 0  0  0  0 0 0 0 0 0  0  0  0 0 0 0 0 0  0  0  0  0  0  0  0  0 0 0 0 0 0  0  0  0  0  0  0  0 0 0 0 0 0 0  0  0  0  0 0 0 0  0 0 0  0 0 0 0  0 0 0  0 0 0 0  0 0 0  0  0  0 0 0  0 0 0  0 0 0  0 0 0  0 0 0  0 0 20
22 22 22 22 22 4  0  0  0  0  0  0  0  0  0  0  0  0 0 0 0 0  0  0  0 0 0 0 0 0  0  0  0 0 0 0 0 0  0  0  0  0  0  0  0  0 0 0 0 0 0  0  0  0  0  0  0  0 0 0 0 0 0 0  0  0  0  0 0 0 0  0 0 0  0 0 0 0  0 0 0  0 0 0 0  0 0 0  0  0  0 0 0  0 0 0  0 0 0  0 1 21 2 0 0  0 1 21
22 22 22 22 22 4  0  0  0  0  0  0  0  0  0  0  0  0 0 0 0 0  0  0  0 0 0 0 1 21 21 21 2 0 0 0 0 23 24 24 24 24 24 24 25 0 0 0 0 0 0  0  0  0  0  0  0  0 0 0 0 0 0 0  0  0  0  0 0 0 0  0 0 0  0 0 0 0  0 0 0  0 0 0 0  0 0 0  0  0  0 0 0  0 0 0  0 1 21 2 3 22 4 1 21 2 3 22
22 22 22 22 22 4  0  0  0  0  0  0  0  0  0  0  0  0 0 0 1 21 21 21 2 0 0 0 3 22 22 22 4 0 0 0 0 0  0  0  0  0  0  0  0  0 0 0 0 0 23 24 24 24 24 24 25 0 0 0 0 0 0 1 21 21 21 21 2 0 0  0 0 0  0 0 0 0  0 0 0  0 0 0 0  0 0 0  1  21 2 0 0  0 1 21 2 3 22 4 3 22 4 3 22 4 3 22
17 17 17 17 17 0  0  0  0  0  0  0  0  0  0  0  0  0 0 0 3 22 22 22 4 0 0 0 3 22 22 22 4 0 0 0 0 0  0  0  0  0  0  0  0  0 0 0 0 0 0  0  0  0  0  0  0  0 0 0 0 0 0 3 22 22 22 22 4 1 21 2 1 21 2 0 0 0  0 1 21 2 0 0 0  0 1 21 2  22 4 1 21 2 3 22 4 3 22 4 3 22 4 3 22 4 3 22
21 21 21 21 21 21 21 21 21 21 21 21 21 21 21 21 21 2 0 0 3 22 22 22 4 0 0 0 3 22 22 22 4 0 0 0 0 0  0  0  0  0  0  0  0  0 0 0 0 0 0  0  0  0  0  0  0  0 0 0 0 0 0 3 22 22 22 22 4 3 22 4 3 22 4 0 1 21 2 3 22 4 0 1 21 2 3 22 3  22 4 3 22 4 3 22 4 3 22 4 3 22 4 3 22 4 3 22
