107
8
0  0  0  0  0  0  0  0  0  0  0  0  0  0  0  0  0 0 0  0 0  0  0  0  0  0  0  0  0  0  0  0  0  0  0  0  0  0  0  0  0  0  0 0 0  0  0  0  0  0  0  0  0  0  0  0  0  0  0  0  0  0  0  0  0  0  0  0  0  0  0  0  0  0  0  0  0  0  0  0  0  0  0  0  0  0  0  0  0  0  0  0  0  0  0  0  0  0  0  0  0  0  0  0  0  1  22
0  0  0  0  0  0  0  0  0  0  0  0  0  0  0  0  0 0 0  0 0  0  0  0  0  0  0  0  0  0  0  0  0  0  0  0  0  0  0  0  0  0  0 0 0  0  0  0  0  0  0  0  0  0  0  0  0  0  0  0  0  0  0  0  0  0  0  0  0  0  0  0  0  0  0  0  0  0  0  0  0  0  0  0  0  0  0  0  0  0  0  0  0  0  0  0  0  0  0  0  0  0  0  0  0  3  22
0  0  0  0  0  0  0  0  0  0  0  0  0  0  0  0  0 0 0  0 0  0  0  0  0  0  0  0  0  0  0  0  0  0  0  0  0  0  0  0  0  0  0 0 0  0  0  0  0  0  0  0  23 24 25 0  0  0  0  0  0  0  0  0  0  0  0  0  0  0  0  0  0  23 24 25 0  0  0  0  0  0  0  0  0  0  0  0  0  0  0  0  0  0  0  0  0  0  0  0  0  0  0  0  0  3  22
0  0  0  0  0  0  0  0  0  0  0  0  0  0  0  0  0 0 0  0 0  0  0  0  0  0  0  0  0  0  0  0  0  0  0  0  0  0  0  23 24 25 0 0 0  0  0  0  0  0  0  0  0  0  0  0  0  0  0  0  0  0  0  0  0  0  0  0  0  0  0  0  0  0  0  0  0  0  0  0  0  0  0  0  0  0  0  0  0  0  0  0  0  0  0  0  0  0  0  0  0  0  0  0  0  3  22
0  0  0  0  0  0  0  0  0  0  0  0  0  1  21 21 2 0 0  0 0  0  0  0  0  0  0  0  0  0  0  0  0  23 25 0  0  0  0  0  0  0  0 0 0  0  0  0  0  0  0  0  0  0  0  0  0  0  0  0  0  1  21 21 21 2  0  0  0  0  0  0  0  0  0  0  0  0  0  23 24 25 0  0  1  21 2  0  0  0  0  0  0  0  0  0  0  0  0  1  21 21 2  0  0  3  22
0  0  0  0  0  0  0  0  0  0  1  21 21 21 6  22 4 0 0  0 0  0  0  0  0  0  0  0  0  0  0  0  0  0  0  0  0  0  0  0  0  0  0 1 21 21 21 21 2  0  0  0  0  0  0  0  0  0  0  0  0  3  22 22 22 4  0  0  0  0  0  0  0  0  0  0  0  0  0  0  0  0  0  0  3  22 4  0  0  0  0  0  0  0  0  0  0  0  0  3  22 22 4  0  0  1  22
0  0  0  0  0  0  0  0  0  0  3  22 22 22 22 22 4 0 0  1 21 21 21 21 21 2  0  0  0  1  21 21 2  0  0  1  21 21 2  0  0  0  0 3 22 22 22 22 4  0  0  1  21 2  0  0  1  21 2  0 1  21  6  22 22 4  0  0  0  0  0  0  0  0  0  0  0  0  0  0  0  0  0  1  21 7  21 2  0  0  0  0  0  0  0  0  0  0  1  21 6  22 4  0  0  0  20
21 21 21 21 21 21 21 21 21 21 21 6  22 22 22 22 4 0 0  3 22 22 22 22 5  21 21 21 21 21 6  5  21 21 21 21 6  22 4  0  0  0  0 3 22 22 22 5  21 21 21 21 7  21 21 21 21 7  21 21 21 6  22 22 22 4  0  0  0  0  0  1  21 21 21 21 21 21 21 21 21 21 21 21 6  22 5  21 21 21 21 21 21 21 21 21 21 21 21 6  22 5  21 21 21 21 21
